OXXOOOOOXXXXXXX
OOXOXXXOXXXXXXX 
XOXOXXOOOOOOOOX
OOXOXXXOXXXXXXX
OXXOXXOOOOOOXXX
OXXOXXOOXXXOXXX
OOOOXOXXOOOOXXX
XXXXXXXXOXXXXXX
OOOOOOOOOOOOOXX
XXOXXXXXXXXXXXX
XXOXXOOOOOXXXXX
XXOXXOXXXOXXOOO
XXOOOOXXXOOXXXO
XXOXXOXXOXOOOXO
XXOXXOXXXXOXOOO