DXXOOOOOOOOOOOX
OOXOOXXOXXXXXXX 
XOXOXXOOOOOOOOX
OOXOOXOXXXXXXXX
OXXOXXOOOOOOOOO
OXXOOXXXXOXXXOO
OXOOOOOOOXOOOOO
OXXXXXXXOXXOXXO
OXOOOOOOOXOOOXO
OXOOXXXXXXOXXXO
OXOXXOOOOOOXXXO
OXOXXOXXXXXOOOO
OOOXOOXOOOOXXXO
XXOXXOOOOXOOOXX
XXOXXOXXXXOXOOF